#S########
#     ####
####  ####
#  ## # ##
###   ## #
####  ####
####  ####
##  #  E##
##########
##########
